Name,TotalChurchMembership,Stakes,Congregations,Wards,Branches,FamilySearchCenters,Temples,Missions,Districts
Alabama,41239,8,73,45,28,44,1,1,0
Alaska,33987,9,81,59,22,15,1,1,0
Arizona,444789,118,904,818,86,74,6,6,0
Arkansas,37524,7,76,54,22,25,1,2,0
California,728639,147,1099,957,142,228,8,16,0
Colorado,149722,35,310,275,35,64,2,4,0
Connecticut,16366,3,31,25,6,10,1,0,0
Delaware,5865,2,10,9,1,3,0,0,0
District of Columbia,3337,0,4,4,0,1,0,0,0
Florida,176291,32,278,222,56,84,3,5,0
Georgia,92583,19,161,133,28,44,1,2,0
Hawaii,76357,16,142,127,15,26,2,2,0
Idaho,481049,142,1274,1224,50,70,6,3,0
Illinois,58886,12,119,89,30,42,2,1,0
Indiana,48851,13,101,79,22,40,1,1,0
Iowa,29762,8,68,44,24,30,0,1,0
Kansas,40003,7,75,60,15,29,0,1,0
Kentucky,39875,8,81,51,30,28,1,1,0
Louisiana,30076,7,53,33,20,15,1,1,0
Maine,11384,2,27,18,9,10,0,0,0
Maryland,44649,10,83,65,18,14,1,2,0
Massachusetts,28940,7,55,42,13,18,1,1,0
Michigan,46847,10,99,62,37,43,1,2,1
Minnesota,34112,8,75,54,21,29,1,1,0
Mississippi,22402,4,48,30,18,20,0,0,0
Missouri,83213,19,177,149,28,51,2,2,0
Montana,52446,13,135,92,43,50,2,2,0
Nebraska,26299,5,57,42,15,18,1,1,0
Nevada,183097,43,337,302,35,34,2,4,0
New Hampshire,8713,3,18,14,4,6,0,1,0
New Jersey,36374,6,61,41,20,20,0,1,0
New Mexico,69451,14,137,104,33,31,1,2,0
New York,90634,17,146,98,48,65,2,2,1
North Carolina,97653,20,188,142,46,51,1,2,0
North Dakota,11896,3,27,20,7,7,1,1,0
Ohio,65809,15,128,99,29,46,1,2,0
Oklahoma,53614,11,94,77,17,30,1,1,0
Oregon,150416,34,287,239,48,76,2,3,0
Pennsylvania,54015,13,105,76,29,46,2,2,0
Rhode Island,4861,1,9,8,1,1,0,0,0
South Carolina,46586,10,83,65,18,23,1,2,0
South Dakota,11979,2,32,14,18,13,0,0,0
Tennessee,60865,12,116,87,29,35,2,2,0
Texas,392400,81,754,625,129,138,5,12,2
Utah,2205134,640,5386,5070,316,170,23,13,6
Vermont,4647,1,10,8,2,8,0,0,0
Virginia,100031,22,213,177,36,46,1,2,0
Washington,282266,61,473,424,49,97,4,7,0
West Virginia,17762,4,38,25,13,14,0,1,0
Wisconsin,28741,6,69,48,21,29,0,1,0
Wyoming,67518,19,171,141,30,46,2,0,0
